{
  "shuffleMoves": {
    "min": 48,
    "max": 160
  },
  "map": [
    "#########",
    "#.......#",
    "#..#.#..#",
    "#.......#",
    "#.#...#.#",
    "#.......#",
    "#..#.#..#",
    "#.......#",
    "#########"
  ],
  "targets": [
    [2, 4],
    [4, 3],
    [4, 5],
    [6, 4]
  ],
  "playerStart": [4, 4],
  "levels": [
    {
      "name": "Training Dock",
      "layout": [
        "#####",
        "#@  #",
        "# $ #",
        "# . #",
        "#####"
      ]
    },
    {
      "name": "Double Shift",
      "layout": [
        "######",
        "# .  #",
        "# $$ #",
        "#  .@#",
        "######"
      ]
    },
    {
      "name": "Crossing Lanes",
      "layout": [
        "#######",
        "# . . #",
        "# $$@ #",
        "#     #",
        "#######"
      ]
    },
    {
      "name": "Storage Split",
      "layout": [
        "#######",
        "#  .  #",
        "# $$# #",
        "#  .@ #",
        "#######"
      ]
    },
    {
      "name": "Warehouse Loop",
      "layout": [
        "########",
        "#  .  @#",
        "# $$ $ #",
        "#  . . #",
        "########"
      ]
    },
    {
      "name": "Orbital Depot",
      "layout": [
        "########",
        "# @    #",
        "# $$#  #",
        "#  .$. #",
        "#   .  #",
        "########"
      ]
    },
    {
      "name": "Tight Corners",
      "layout": [
        "########",
        "#  .  ##",
        "# $$@  #",
        "#  # $ #",
        "#  . . #",
        "########"
      ]
    },
    {
      "name": "Central Support",
      "layout": [
        "########",
        "#  . . #",
        "# $$#$ #",
        "# @  $ #",
        "#  ##  #",
        "#  . . #",
        "########"
      ]
    }
  ]
}
